111111111111111111
1E0000000000000C01
101001010010000011
101001001010101001
100000000C00C00001
1000000000000000M1
100000000000000001
100000000000000C01
101001010010000011
101001001010101001
1P0000000C00C00001
111111111111111111