111111111111111111
1E000000C000000001
101001010010000011
1010010010101010P1
100000000000000001
1000000000000000M1
111111111111111111