11111111111111111111111
1E000000C00000000000001
10100101001000001000001
10100100101010100000001
10000000P00000000000001
10000000C00000000000001
10000000000000000000001
100C000000000000C000001
10000000001000000000001
10000001M10000000000001
10000000100000000100001
11111111111111111111111