111111111
100011001
100P00001
111111111