111111111111111111
1P0000000000000C01
101001010010000011
101001001010101001
100000000000000001
100000000000C00001
100000000000000001
1000000000000E0001
111111111111111111